11111111111111111111111
111100000000CEPCCCCC111
11111111111111111111111

