111111
11C111
1P0E11
110011
111111
