11111
11C11
1P0E1
11101
11111





























