111111
11C111
1P0E11
110111
111111









