11111111111
11111111111
11000000111
11E1CP00111
11111111111
