1111111111111
1C000E00000C1
1001101111001
1P000C0000001
1111101011011
1111111111111
