11111111111111
11111111111111
100EC111111111
11P11111111111
11111111111111
11111111111111
