11111111111111
111100C1111111
10E00111111111
11P11111011111
11111111111111
11111111111111
