11111111111111
11111111111111
1C0000000000E1
111111000P0011
10111111111001
11111111111111
