11111111111111
11111111111111
1C0000000001E1
111101000P0011
1C000111111001
11111111111111
