11111111111111111111111
111100000000CEPCC0CC111
11111111111111111111111
